ZZZZZZZZZZZZZZZZZZZZRZZZWZZZZZZZ
ZZZZZCTZZZRRRRRRRRZZRZZZWZZZZZCZ
RRRZZZZZZRRZZZZZZRRZRHZZWTZZZZZZ
ZZRZZZZZRRBZZCZZZZBZZZZZGZZZTZZZ
ZZRZRRZZRZBZZZZTZZRZZZZZWTZZZZZZ
ZZZZTRZZZZBZZRRRZRRRBBBBWZZZZZZZ
ZZZZZRWWWZBZRRZZZZWRZZZZWZZTZTZZ
ZHZZZZWHWRRZRWBBBBWRHCZZWWWWGWWW
ZZZZZZBZZZRRRWZZZZWRZZZZZBZZZZZZ
ZZZZZZBZZZZZRWZZZZWRRRZZZBZZZZZZ
WWWGWWWWZZCHRWBBBBWRZRRWHWZZZZHZ
ZZTZTZZWZZZZRWZZZZRRZBZWWWRZZZZZ
ZZZZZZZWBBBBRRRZRRRZZBZZZZRTZZZZ
ZZZZZZTWZZZZZRZZTZZZZBZRZZRRZRZZ
ZZZTZZZGZZZZZBZZZZCZZBRRZZZZZRZZ
ZZZZZZTWZZHRZRRZZZZZZRRZZZZZZRRR
ZCZZZZZWZZZRZZRRRRRRRRZZZTCZZZZZ
ZZZZZZZWZZZRZZZZZZZZZZZZZZZZZZZZ