ZZZZZZZZZZZZZZZZZZZZRZZZWZZZZZZZ
ZZZZZ1TZZZRRRRRRRRZZRZZZWZZZZZ3Z
RRRZZZZZZRRZZZZZZRRZRHZZWTZZZZZZ
ZZRZZZZZRRBZZ1ZZZZBZZZZZGZZZTZZZ
ZZRZRRZZRZBZZZZTZZRZZZZZWTZZZZZZ
ZZZZTRZZZZBZZRRRZRRRBBBBWZZZZZZZ
ZZZZZRWWWZBZRRZZZZWRZZZZWZZTZTZZ
ZHZZZZWHWRRZRWBBBBWRH1ZZWWWWGWWW
ZZZZZZBZZZRRRWZZZZWRZZZZZBZZZZZZ
ZZZZZZBZZZZZRWZZZZWRRRZZZBZZZZZZ
WWWGWWWWZZ1HRWBBBBWRZRRWHWZZZZHZ
ZZTZTZZWZZZZRWZZZZRRZBZWWWRZZZZZ
ZZZZZZZWBBBBRRRZRRRZZBZZZZRTZZZZ
ZZZZZZTWZZZZZRZZTZZZZBZRZZRRZRZZ
ZZZTZZZGZZZZZBZZZZ1ZZBRRZZZZZRZZ
ZZZZZZTWZZHRZRRZZZZZZRRZZZZZZRRR
Z2ZZZZZWZZZRZZRRRRRRRRZZZT1ZZZZZ
ZZZZZZZWZZZRZZZZZZZZZZZZZZZZZZZZ